Level 01 - Tutorial
######
# @  #
# $$ #
# xx #
######