Level 01 - Tutorial
######
#  @ #
#  $ #
#  ###
#   x#
######